Call_ID,Arrival_Time,Service_Start_Time,Service_End_Time,Waiting_Time,Service_Duration,Agent_ID,Queue_Length_On_Arrival
1,3,3,12.42,0,9.42,1,0
2,5,5,99.24,0,94.24,2,0
3,6,6,70.56,0,64.56,3,0
4,7,13,46.14,6,33.14,1,0
5,14,47,53.59,33,6.59,1,8
6,17,54,64.71,37,10.71,1,12
7,18,65,152.36,47,87.36,1,17
8,19,71,92.7,52,21.7,3,19
9,28,93,101.61,65,8.61,3,24
10,32,100,125.81,68,25.81,2,23
11,39,102,118.81,63,16.81,3,23
12,42,119,181.6,77,62.6,3,26
13,45,126,207.82,81,81.82,2,25
14,48,153,324.71,105,171.71,1,27
15,50,182,223.36,132,41.36,3,31
16,51,208,223.18,157,15.18,2,36
17,52,224,249.2,172,25.2,2,38
18,53,224,242.49,171,18.49,3,37
19,55,243,318.77,188,75.77,3,41
20,58,250,251.33,192,1.33,2,42
21,59,252,280.55,193,28.55,2,41
22,62,281,308.04,219,27.04,2,49
23,63,309,342.53,246,33.53,2,55
24,64,319,346.37,255,27.37,3,58
25,66,325,361.09,259,36.09,1,57
26,69,343,353.43,274,10.43,2,60
27,70,347,436.0,277,89.0,3,60
28,72,354,354.48,282,0.48,2,61
29,75,355,455.29,280,100.29,2,60
30,76,362,445.31,286,83.31,1,60
31,78,436,471.87,358,35.87,3,76
32,85,446,476.76,361,30.76,1,77
33,93,456,466.22,363,10.22,2,78
34,102,467,483.75,365,16.75,2,81
35,104,472,485.19,368,13.19,3,80
36,105,477,536.13,372,59.13,1,80
37,106,484,491.17,378,7.17,2,82
38,119,486,584.75,367,98.75,3,81
39,128,492,498.92,364,6.92,2,82
40,129,499,499.33,370,0.33,2,85
41,133,500,533.51,367,33.51,2,84
42,157,534,582.91,377,48.91,2,91
43,158,537,538.42,379,1.42,1,91
44,160,539,562.66,379,23.66,1,90
45,167,563,563.62,396,0.62,1,93
46,171,564,622.71,393,58.71,1,93
47,187,583,611.46,396,28.46,2,95
48,188,585,594.6,397,9.6,3,95
49,192,595,619.34,403,24.34,3,97
50,194,612,671.9,418,59.9,2,100
51,199,620,629.43,421,9.43,3,100
52,205,623,642.29,418,19.29,1,99
53,220,630,639.88,410,9.88,3,99
54,221,640,645.9,419,5.9,3,100
55,223,643,691.01,420,48.01,1,100
56,225,646,655.61,421,9.61,3,100
57,230,656,690.87,426,34.87,3,105
58,235,672,685.25,437,13.25,2,109
59,236,686,692.8,450,6.8,2,112
60,242,691,816.22,449,125.22,3,111
61,244,692,732.21,448,40.21,1,111
62,246,693,694.45,447,1.45,2,111
63,253,695,754.62,442,59.62,2,110
64,254,733,772.69,479,39.69,1,118
65,255,755,758.18,500,3.18,2,119
66,272,759,761.25,487,2.25,2,118
67,273,762,769.12,489,7.12,2,119
68,274,770,786.92,496,16.92,2,118
69,275,773,780.56,498,7.56,1,117
70,277,781,798.45,504,17.45,1,117
71,279,787,799.93,508,12.93,2,117
72,284,799,843.42,515,44.42,1,119
73,287,800,813.52,513,13.52,2,118
74,292,814,832.01,522,18.01,2,121
75,297,817,889.3,520,72.3,3,120
76,303,833,910.84,530,77.84,2,121
77,305,844,848.49,539,4.49,1,123
78,307,849,865.56,542,16.56,1,124
79,314,866,919.81,552,53.81,1,128
80,315,890,990.07,575,100.07,3,132
81,316,911,941.46,595,30.46,2,138
82,318,920,924.76,602,4.76,1,139
83,326,925,937.77,599,12.77,1,138
84,327,938,968.58,611,30.58,1,140
85,333,942,951.18,609,9.18,2,140
86,336,952,965.41,616,13.41,2,143
87,344,966,989.03,622,23.03,2,144
88,350,969,996.8,619,27.8,1,144
89,353,990,994.46,637,4.46,2,149
90,360,991,1024.29,631,33.29,3,148
91,363,995,1004.59,632,9.59,2,147
92,369,997,1034.8,628,37.8,1,146
93,370,1005,1062.58,635,57.58,2,147
94,372,1025,1068.91,653,43.91,3,150
95,382,1035,1049.34,653,14.34,1,151
96,383,1050,1168.51,667,118.51,1,151
97,390,1063,1145.13,673,82.13,2,152
98,401,1069,1107.39,668,38.39,3,153
99,406,1108,1200.01,702,92.01,3,160
100,407,1146,1157.31,739,11.31,2,168
101,409,1158,1176.14,749,18.14,2,170
102,410,1169,1191.9,759,22.9,1,170
103,411,1177,1198.95,766,21.95,2,173
104,416,1192,1203.86,776,11.86,1,176
105,422,1199,1216.27,777,17.27,2,177
106,426,1201,1223.88,775,22.88,3,176
107,427,1204,1207.28,777,3.28,1,175
108,443,1208,1231.65,765,23.65,1,175
109,444,1217,1228.18,773,11.18,2,176
110,452,1224,1250.46,772,26.46,3,176
111,454,1229,1262.65,775,33.65,2,177
112,461,1232,1233.93,771,1.93,1,177
113,462,1234,1240.15,772,6.15,1,176
114,463,1241,1259.64,778,18.64,1,176
115,466,1251,1283.56,785,32.56,3,177
116,473,1260,1345.22,787,85.22,1,176
117,481,1263,1269.6,782,6.6,2,175
118,482,1270,1282.44,788,12.44,2,175
119,483,1283,1287.77,800,4.77,2,175
120,490,1284,1368.46,794,84.46,3,174
121,492,1288,1288.07,796,0.07,2,173
122,493,1289,1320.91,796,31.91,2,172
123,494,1321,1353.22,827,32.22,2,173
124,495,1346,1403.38,851,57.38,1,176
125,498,1354,1361.6,856,7.6,2,178
126,503,1362,1390.64,859,28.64,2,177
127,510,1369,1401.62,859,32.62,3,176
128,511,1391,1392.82,880,1.82,2,177
129,515,1393,1448.44,878,55.44,2,176
130,516,1402,1451.99,886,49.99,3,178
131,522,1404,1419.7,882,15.7,1,177
132,529,1420,1465.85,891,45.85,1,179
133,532,1449,1471.27,917,22.27,2,185
134,537,1452,1485.28,915,33.28,3,185
135,544,1466,1477.84,922,11.84,1,185
136,545,1472,1484.6,927,12.6,2,184
137,549,1478,1501.91,929,23.91,1,183
138,556,1485,1523.58,929,38.58,2,185
139,564,1486,1504.97,922,18.97,3,184
140,565,1502,1513.66,937,11.66,1,185
141,567,1505,1523.68,938,18.68,3,184
142,580,1514,1519.15,934,5.15,1,185
143,585,1520,1577.7,935,57.7,1,184
144,593,1524,1536.83,931,12.83,2,183
145,594,1524,1548.69,930,24.69,3,182
146,595,1537,1587.32,942,50.32,2,185
147,596,1549,1568.21,953,19.21,3,185
148,608,1569,1647.81,961,78.81,3,184
149,610,1578,1600.72,968,22.72,1,184
150,611,1588,1687.72,977,99.72,2,184
151,615,1601,1678.68,986,77.68,1,187
152,627,1648,1666.7,1021,18.7,3,197
153,633,1667,1708.51,1034,41.51,3,200
154,636,1679,1707.1,1043,28.1,1,201
155,642,1688,1703.13,1046,15.13,2,202
156,646,1704,1715.11,1058,11.11,2,203
157,647,1708,1748.09,1061,40.09,1,203
158,648,1709,1884.19,1061,175.19,3,202
159,649,1716,1716.8,1067,0.8,2,201
160,650,1717,1757.15,1067,40.15,2,200
161,651,1749,1763.66,1098,14.66,1,203
162,654,1758,1808.68,1104,50.68,2,207
163,661,1764,1853.54,1103,89.54,1,206
164,663,1809,1809.59,1146,0.59,2,214
165,664,1810,1831.99,1146,21.99,2,213
166,665,1832,1873.88,1167,41.88,2,218
167,666,1854,1872.93,1188,18.93,1,222
168,673,1873,1893.49,1200,20.49,1,224
169,674,1874,1884.42,1200,10.42,2,223
170,675,1885,1943.45,1210,58.45,2,225
171,679,1885,1897.46,1206,12.46,3,224
172,692,1894,1914.66,1202,20.66,1,225
173,693,1898,1907.39,1205,9.39,3,227
174,700,1908,1936.85,1208,28.85,3,227
175,707,1915,1933.36,1208,18.36,1,228
176,719,1934,1937.28,1215,3.28,1,229
177,720,1937,2018.42,1217,81.42,3,228
178,723,1938,1952.49,1215,14.49,1,227
179,725,1944,2000.58,1219,56.58,2,227
180,728,1953,1973.31,1225,20.31,1,227
181,732,1974,2027.57,1242,53.57,1,229
182,733,2001,2022.15,1268,21.15,2,234
183,740,2019,2056.95,1279,37.95,3,237
184,744,2023,2055.32,1279,32.32,2,236
185,760,2028,2042.81,1268,14.81,1,235
186,762,2043,2083.76,1281,40.76,1,237
187,780,2056,2075.05,1276,19.05,2,239
188,786,2057,2059.95,1271,2.95,3,238
189,788,2060,2079.22,1272,19.22,3,238
190,790,2076,2083.4,1286,7.4,2,242
191,799,2080,2127.98,1281,47.98,3,241
192,801,2084,2153.38,1283,69.38,1,240
193,807,2084,2097.46,1277,13.46,2,239
194,810,2098,2178.41,1288,80.41,2,238
195,812,2128,2136.43,1316,8.43,3,245
196,826,2137,2148.15,1311,11.15,3,245
197,828,2149,2182.45,1321,33.45,3,246
198,834,2154,2199.44,1320,45.44,1,245
199,836,2179,2203.44,1343,24.44,2,250
200,840,2183,2192.9,1343,9.9,3,249
201,847,2193,2259.84,1346,66.84,3,248
202,849,2200,2221.57,1351,21.57,1,248
203,850,2204,2214.9,1354,10.9,2,249
204,851,2215,2233.0,1364,18.0,2,251
205,854,2222,2243.68,1368,21.68,1,250
206,861,2233,2260.39,1372,27.39,2,256
207,864,2244,2285.23,1380,41.23,1,256
208,868,2260,2275.97,1392,15.97,3,255
209,873,2261,2270.06,1388,9.06,2,254
210,882,2271,2332.37,1389,61.37,2,254
211,883,2276,2327.45,1393,51.45,3,254
212,889,2286,2367.69,1397,81.69,1,254
213,901,2328,2341.18,1427,13.18,3,258
214,902,2333,2334.57,1431,1.57,2,258
215,903,2335,2360.48,1432,25.48,2,257
216,905,2342,2365.2,1437,23.2,3,257
217,907,2361,2377.08,1454,16.08,2,260
218,909,2366,2389.13,1457,23.13,3,259
219,910,2368,2396.12,1458,28.12,1,258
220,917,2378,2398.75,1461,20.75,2,261
221,918,2390,2390.36,1472,0.36,3,263
222,931,2391,2412.98,1460,21.98,3,262
223,932,2397,2498.48,1465,101.48,1,261
224,936,2399,2404.68,1463,5.68,2,262
225,941,2405,2423.99,1464,18.99,2,261
226,947,2413,2434.48,1466,21.48,3,262
227,948,2424,2438.53,1476,14.53,2,263
228,949,2435,2465.53,1486,30.53,3,264
229,952,2439,2504.54,1487,65.54,2,263
230,956,2466,2487.5,1510,21.5,3,264
231,961,2488,2520.3,1527,32.3,3,267
232,968,2499,2515.93,1531,16.93,1,270
233,976,2505,2509.76,1529,4.76,2,269
234,979,2510,2518.05,1531,8.05,2,268
235,986,2516,2613.04,1530,97.04,1,268
236,987,2519,2583.22,1532,64.22,2,267
237,988,2521,2563.64,1533,42.64,3,267
238,989,2564,2619.94,1575,55.94,3,271
239,998,2584,2588.18,1586,4.18,2,274
240,999,2589,2591.93,1590,2.93,2,275
241,1010,2592,2656.27,1582,64.27,2,275
242,1015,2614,2621.95,1599,7.95,1,277
243,1019,2620,2630.0,1601,10.0,3,276
244,1022,2622,2683.87,1600,61.87,1,276
245,1027,2630,2675.91,1603,45.91,3,277
246,1030,2657,2658.84,1627,1.84,2,284
247,1036,2659,2703.09,1623,44.09,2,284
248,1052,2676,2708.95,1624,32.95,3,287
249,1061,2684,2701.47,1623,17.47,1,289
250,1068,2702,2712.35,1634,10.35,1,292
251,1069,2704,2729.46,1635,25.46,2,292
252,1072,2709,2717.29,1637,8.29,3,292
253,1073,2713,2742.6,1640,29.6,1,291
254,1074,2718,2718.61,1644,0.61,3,292
255,1080,2719,2808.59,1639,89.59,3,291
256,1089,2730,2851.16,1641,121.16,2,292
257,1103,2743,2808.45,1640,65.45,1,293
258,1104,2809,2821.82,1705,12.82,1,310
259,1105,2809,2810.72,1704,1.72,3,309
260,1114,2811,2838.63,1697,27.63,3,308
261,1122,2822,2840.25,1700,18.25,1,307
262,1127,2839,2849.59,1712,10.59,3,309
263,1128,2841,2864.63,1713,23.63,1,308
264,1131,2850,2880.98,1719,30.98,3,311
265,1136,2852,2857.98,1716,5.98,2,311
266,1137,2858,2859.82,1721,1.82,2,311
267,1138,2860,2943.68,1722,83.68,2,310
268,1144,2865,2892.5,1721,27.5,1,313
269,1148,2881,2883.61,1733,2.61,3,315
270,1149,2884,2914.2,1735,30.2,3,315
271,1155,2893,2916.07,1738,23.07,1,314
272,1168,2915,2919.99,1747,4.99,3,320
273,1170,2917,2996.03,1747,79.03,1,319
274,1172,2920,2928.38,1748,8.38,3,318
275,1173,2929,2938.24,1756,9.24,3,317
276,1177,2939,2990.92,1762,51.92,3,319
277,1186,2944,3018.98,1758,74.98,2,319
278,1187,2991,2998.48,1804,7.48,3,327
279,1188,2997,3035.75,1809,38.75,1,326
280,1191,2999,3015.2,1808,16.2,3,325
281,1195,3016,3018.27,1821,2.27,3,328
282,1199,3019,3050.27,1820,31.27,2,328
283,1207,3019,3137.54,1812,118.54,3,327
284,1211,3036,3038.63,1825,2.63,1,331
285,1215,3039,3066.6,1824,27.6,1,331
286,1218,3051,3069.91,1833,18.91,2,336
287,1226,3067,3089.14,1841,22.14,1,338
288,1227,3070,3074.2,1843,4.2,2,337
289,1231,3075,3137.93,1844,62.93,2,338
290,1241,3090,3100.79,1849,10.79,1,344
291,1243,3101,3131.36,1858,30.36,1,343
292,1244,3132,3153.98,1888,21.98,1,349
293,1269,3138,3168.52,1869,30.52,2,348
294,1271,3138,3138.04,1867,0.04,3,347
295,1307,3139,3222.57,1832,83.57,3,346
296,1318,3154,3291.09,1836,137.09,1,349
297,1325,3169,3200.48,1844,31.48,2,351
298,1327,3201,3204.86,1874,3.86,2,353
299,1338,3205,3247.69,1867,42.69,2,352
300,1343,3223,3228.91,1880,5.91,3,352
301,1347,3229,3296.01,1882,67.01,3,355
302,1349,3248,3299.45,1899,51.45,2,355
303,1352,3292,3294.58,1940,2.58,1,363
304,1380,3295,3318.18,1915,23.18,1,362
305,1381,3297,3300.88,1916,3.88,3,361
306,1397,3300,3325.26,1903,25.26,2,361
307,1399,3301,3332.95,1902,31.95,3,360
308,1400,3319,3364.23,1919,45.23,1,362
309,1407,3326,3329.54,1919,3.54,2,363
310,1413,3330,3380.86,1917,50.86,2,362
311,1414,3333,3333.23,1919,0.23,3,361
312,1423,3334,3412.69,1911,78.69,3,360
313,1424,3365,3375.43,1941,10.43,1,365
314,1439,3376,3418.5,1937,42.5,1,372
315,1440,3381,3423.45,1941,42.45,2,371
316,1442,3413,3433.02,1971,20.02,3,375
317,1443,3419,3424.62,1976,5.62,1,375
318,1448,3424,3447.12,1976,23.12,2,375
319,1450,3425,3432.53,1975,7.53,1,374
320,1464,3433,3433.3,1969,0.3,1,377
321,1482,3434,3455.2,1952,21.2,1,376
322,1484,3434,3443.49,1950,9.49,3,375
323,1485,3444,3452.9,1959,8.9,3,375
324,1490,3448,3463.69,1958,15.69,2,374
325,1492,3453,3471.91,1961,18.91,3,375
326,1507,3456,3476.6,1949,20.6,1,375
327,1508,3464,3511.0,1956,47.0,2,374
328,1527,3472,3487.33,1945,15.33,3,377
329,1528,3477,3530.06,1949,53.06,1,376
330,1530,3488,3494.84,1958,6.84,3,380
331,1533,3495,3558.41,1962,63.41,3,379
332,1547,3511,3538.6,1964,27.6,2,384
333,1578,3531,3556.45,1953,25.45,1,390
334,1580,3539,3553.64,1959,14.64,2,389
335,1589,3554,3641.07,1965,87.07,2,390
336,1594,3557,3564.46,1963,7.46,1,389
337,1596,3559,3636.43,1963,77.43,3,388
338,1599,3565,3576.0,1966,11.0,1,388
339,1606,3577,3592.85,1971,15.85,1,391
340,1607,3593,3595.53,1986,2.53,1,392
341,1613,3596,3618.89,1983,22.89,1,392
